********
*   * E*
* * * **
* * * **
* * * **
* * * **
*S*   **
********